WWWWWWWWWW
W........W
W..VVV...W
W..VVV...W
W........W
W....TT..W
WWWWWWWWWW
